1313123131
1   1    3
2   2  1 3
2      1 2
3   1111 3
11111    3
3     2  1
2  2111221
1        4
1212121211