1231231231
1        2
1    1   1
2321 31  2
3    1   1
1 12332 23
1    1   1
3 11333121
1        4
1231231231